251 251 251 251 251 251 251 251 251 251 251 251 251 251 251 251 251 251 251 251 251 251 251 251 251 251 251 251 251 251 251 251 251 251 251 251 251 251 251 251 251 251 251 251 251 251 251 251 251 251 
251 251 251 251 251 251 251 251 251 251 251 251 251 251 251 251 251 251 251 251 251 251 251 251 251 251 251 251 251 188 251 251 251 251 251 251 251 251 251 251 251 251 251 251 251 251 251 251 251 251 
251 251 251 251 251 251 251 251 251 251 251 251 251 251 251 251 251 251 251 251 251 251 251 251 251 251 251 251 251 251 251 251 251 251 251 251 251 251 251 251 251 251 251 251 251 251 251 251 251 251 
251 251 251 251 251 251 251 251 251 251 251 251 251 251 251 251 251 251 251 251 251 251 251 251 251 251 251 251 251 251 251 251 251 251 251 251 251 251 251 251 251 251 251 251 251 251 251 251 251 251 
251 251 251 251 251 251 251 251 251 251 251 251 251 251 251 251 251 251 251 251 251 251 251 251 251 251 251 251 251 251 251 251 251 251 251 251 251 251 251 251 251 251 251 251 251 251 251 251 251 251 
251 251 251 251 251 251 251 251 251 251 251 251 251 251 251 251 251 251 251 251 251 251 251 248 235 236 237 249 251 251 251 251 251 251 251 251 251 251 251 251 251 251 251 251 251 251 251 251 251 251 
251 251 251 251 251 251 251 251 251 251 251 251 248 236 235 236 236 236 236 236 236 236 236 247 238 239 240 245 246 246 246 236 236 236 237 249 251 251 251 251 251 251 251 251 251 251 251 251 251 251 
251 251 251 251 251 251 251 251 251 251 251 251 253 244 244 250 250 250 238 238 238 238 238 250 241 242 243 238 250 250 250 250 250 250 250 252 251 251 251 251 251 251 251 251 251 251 251 251 251 251 
251 251 251 251 251 251 251 251 251 251 251 251 253 244 244 223 223 223 223 223 223 223 223 223 223 223 223 223 223 223 223 223 223 244 244 252 251 251 251 251 251 251 251 251 251 251 251 251 251 251 
251 251 251 251 251 251 251 251 251 251 251 251 253 244 244 223 223 223 223 223 223 223 223 223 223 223 223 223 223 223 223 223 223 244 244 252 251 251 251 251 251 251 251 251 251 251 251 251 251 251 
251 251 251 251 251 251 251 251 251 251 251 251 253 244 244 223 223 223 223 223 223 223 223 223 223 223 223 223 223 223 223 223 223 244 244 252 251 251 251 251 251 251 251 251 251 251 251 251 251 251 
236 236 236 236 236 236 236 236 236 236 236 236 247 244 244 223 223 223 258 259 223 223 223 223 223 223 223 223 223 223 223 223 223 244 244 252 251 251 251 251 251 251 251 251 251 251 251 251 251 251 
244 244 244 244 244 244 244 244 244 244 244 244 244 244 244 223 223 260 261 262 223 223 223 223 223 223 223 223 223 223 223 223 223 244 244 245 235 235 235 235 235 235 235 235 235 235 249 251 251 251 
244 244 244 244 244 244 244 244 244 244 244 244 244 244 244 223 223 263 264 223 223 223 223 223 223 223 223 223 223 223 223 223 223 244 244 244 244 244 244 244 244 244 244 244 244 244 252 251 251 251 
223 223 223 223 223 223 223 223 223 223 223 223 223 223 223 223 223 223 223 223 223 223 223 223 223 223 223 223 223 223 223 223 223 244 244 244 244 244 244 244 244 244 244 244 244 244 252 251 251 251 
226 226 226 226 226 226 226 226 226 226 226 232 223 254 255 223 223 223 223 223 223 223 223 223 223 223 223 223 223 223 223 223 223 223 223 223 223 223 223 223 223 223 223 223 244 244 252 251 251 251 
234 234 234 234 234 234 234 234 234 234 234 222 223 256 257 223 223 223 223 223 223 223 223 223 223 223 223 223 223 223 223 223 223 223 223 254 255 223 223 223 223 223 223 223 244 244 252 251 251 251 
234 234 234 234 234 234 234 234 234 234 234 222 223 223 223 223 223 223 223 223 223 223 223 223 223 223 223 223 223 223 223 223 223 223 223 256 257 223 223 223 223 223 223 223 244 244 252 251 251 251 
234 234 234 234 234 234 234 234 234 234 234 222 223 223 223 223 223 223 223 223 223 223 258 259 223 223 223 223 223 223 223 223 223 223 223 223 223 223 223 223 223 223 223 223 244 244 252 251 251 251 
234 234 234 234 234 234 234 234 234 234 234 222 223 223 223 223 223 223 223 223 223 260 261 262 223 223 223 223 223 223 223 223 223 223 223 223 223 223 254 255 223 223 223 223 244 244 252 251 251 251 
234 234 234 234 234 234 234 234 234 234 234 222 223 223 223 223 223 223 223 223 223 263 264 223 223 223 223 223 223 223 223 223 223 223 223 223 223 223 256 257 223 223 223 223 244 244 245 235 235 235 
234 234 234 234 234 234 234 234 234 234 234 222 223 223 223 223 223 223 223 223 223 223 223 223 223 223 223 223 223 223 223 223 223 223 223 223 223 223 223 223 223 223 223 223 244 244 238 238 238 238 
234 234 234 234 234 234 234 234 234 234 234 222 223 223 223 223 223 223 223 223 223 223 223 223 223 223 223 223 223 223 223 223 223 223 223 223 223 223 223 223 223 223 223 223 244 244 238 238 238 238 
234 234 234 234 234 234 234 234 234 220 220 228 223 223 223 223 223 223 223 223 223 223 223 223 223 223 223 223 223 223 223 223 223 223 223 223 223 223 223 223 223 223 223 223 223 223 223 223 223 223 
234 234 234 234 234 234 234 219 228 223 223 223 223 223 223 223 223 223 223 223 223 223 223 223 223 223 223 223 223 223 223 223 223 223 223 223 223 223 223 231 226 226 226 226 226 226 226 226 226 226 
234 234 234 234 234 234 234 222 223 223 223 223 223 223 223 223 223 223 223 223 223 223 223 223 223 223 223 223 223 223 223 223 223 223 223 223 223 223 223 224 234 234 234 234 234 234 234 234 234 234 
234 234 234 234 234 234 234 222 223 223 223 223 223 223 223 223 223 223 223 223 223 223 223 223 223 223 223 223 223 223 223 223 223 223 223 223 223 223 223 224 234 234 234 234 234 234 234 234 234 234 
234 234 234 234 234 234 234 222 223 223 223 223 223 223 223 223 223 223 223 223 223 223 223 223 223 223 223 223 223 223 223 223 223 223 223 223 223 223 223 224 234 234 234 234 234 234 234 234 234 234 
234 234 234 234 234 234 234 222 223 223 223 223 223 223 223 223 223 223 223 223 223 223 223 223 223 223 223 223 223 223 223 223 223 223 223 223 223 223 223 224 234 234 234 234 234 234 234 234 234 234 
234 234 234 234 234 234 234 222 223 223 223 223 223 223 223 223 223 223 223 223 223 223 223 223 223 223 223 223 223 223 223 223 223 223 223 223 223 223 223 224 234 234 234 234 234 234 234 234 234 234 
234 234 234 234 234 234 234 222 223 223 254 255 223 223 223 223 223 223 223 223 223 223 223 223 223 223 223 223 254 255 223 223 223 223 223 223 223 223 223 224 234 234 234 234 234 234 234 234 234 234 
234 234 234 234 234 234 234 222 223 223 256 257 223 223 223 231 226 226 226 226 226 230 223 223 223 223 223 223 256 257 223 223 231 226 226 226 226 226 226 233 234 234 234 234 234 234 234 234 234 234 
234 234 234 234 234 234 234 222 223 223 223 223 223 223 223 224 234 234 234 234 234 222 223 223 223 223 223 223 223 223 223 223 224 234 234 234 234 234 234 234 234 234 234 234 234 234 234 234 234 234 
234 234 234 234 234 234 234 222 223 223 223 223 223 223 223 224 234 234 234 234 234 222 223 223 223 223 223 223 223 223 223 223 224 234 234 234 234 234 234 234 234 234 234 234 234 234 234 234 234 234 
234 234 234 234 234 234 234 222 223 223 223 223 223 223 223 224 234 234 234 234 234 222 223 223 223 223 223 223 223 223 223 223 224 234 234 234 234 234 234 234 234 234 234 234 234 234 234 234 234 234 
234 234 234 234 234 234 234 225 226 226 226 226 226 226 226 233 234 234 234 234 234 222 223 223 223 223 223 223 223 223 223 223 224 234 234 234 234 234 234 234 234 234 234 234 234 234 234 234 234 234 
234 234 234 234 234 234 234 234 234 234 234 234 234 234 234 234 234 234 234 234 234 222 223 223 223 223 223 223 223 223 223 223 224 234 234 234 234 234 234 234 234 234 234 234 234 234 234 234 234 234 
234 234 234 234 234 234 234 234 234 234 234 234 234 234 234 234 234 234 234 234 234 225 226 226 226 226 226 226 226 226 226 226 227 234 234 234 234 234 234 234 234 234 234 234 234 234 234 234 234 234 
234 234 234 234 234 234 234 234 234 234 234 234 234 234 234 234 234 234 234 234 234 234 234 234 234 234 234 234 234 234 234 234 234 234 234 234 234 234 234 234 234 234 234 234 234 234 234 234 234 234 
234 234 234 234 234 234 234 234 234 234 234 234 234 234 234 234 234 234 234 234 234 234 234 234 234 234 234 234 234 234 234 234 234 234 234 234 234 234 234 234 234 234 234 234 234 234 234 234 234 234 
234 234 234 234 234 234 234 234 234 234 234 234 234 234 234 234 234 234 234 234 234 234 234 234 234 234 234 234 234 234 234 234 234 234 234 234 234 234 234 234 234 234 234 234 234 234 234 234 234 234 
234 234 234 234 234 234 234 234 234 234 234 234 234 234 234 234 234 234 234 234 234 234 234 234 234 234 234 234 234 234 234 234 234 234 234 234 234 234 234 234 234 234 234 234 234 234 234 234 234 234 
234 234 234 234 234 234 234 234 234 234 234 234 234 234 234 234 234 234 234 234 234 234 234 234 234 234 234 234 234 234 234 234 234 234 234 234 234 234 234 234 234 234 234 234 234 234 234 234 234 234 
234 234 234 234 234 234 234 234 234 234 234 234 234 234 234 234 234 234 234 234 234 234 234 234 234 234 234 234 234 234 234 234 234 234 234 234 234 234 234 234 234 234 234 234 234 234 234 234 234 234 
234 234 234 234 234 234 234 234 234 234 234 234 234 234 234 234 234 234 234 234 234 234 234 234 234 234 234 234 234 234 234 234 234 234 234 234 234 234 234 234 234 234 234 234 234 234 234 234 234 234 
234 234 234 234 234 234 234 234 234 234 234 234 234 234 234 234 234 234 234 234 234 234 234 234 234 234 234 234 234 234 234 234 234 234 234 234 234 234 234 234 234 234 234 234 234 234 234 234 234 234 
234 234 234 234 234 234 234 234 234 234 234 234 234 234 234 234 234 234 234 234 234 234 234 234 234 234 234 234 234 234 234 234 234 234 234 234 234 234 234 234 234 234 234 234 234 234 234 234 234 234 
234 234 234 234 234 234 234 234 234 234 234 234 234 234 234 234 234 234 234 234 234 234 234 234 234 234 234 234 234 234 234 234 234 234 234 234 234 234 234 234 234 234 234 234 234 234 234 234 234 234 
234 234 234 234 234 234 234 234 234 234 234 234 234 234 234 234 234 234 234 234 234 234 234 234 234 234 234 234 234 234 234 234 234 234 234 234 234 234 234 234 234 234 234 234 234 234 234 234 234 234 
234 234 234 234 234 234 234 234 234 234 234 234 234 234 234 234 234 234 234 234 234 234 234 234 234 234 234 234 234 234 234 234 234 234 234 234 234 234 234 234 234 234 234 234 234 234 234 234 234 234 
