59 59 59 59 59 59 59 59 59 59 59 59 59 59 59 59 59 59 59 59 59 97 0 0 0 0 0 0 101 59 59 59 59 59 59 59 59 59 59 97 0 128 0 0 0 0 0 0 129 0 
59 59 59 59 59 59 59 59 59 59 59 59 59 59 59 59 59 59 59 59 59 97 0 0 0 0 0 0 101 59 59 59 59 59 59 59 59 59 59 97 0 128 0 0 0 0 0 0 129 0 
59 59 59 59 59 59 59 59 59 59 59 59 59 59 59 59 59 59 59 59 59 97 0 0 0 0 0 0 101 59 59 59 59 59 59 59 59 59 59 97 0 128 0 0 0 0 0 0 129 0 
59 59 59 59 59 59 59 59 59 59 59 59 59 59 59 59 59 59 59 59 59 97 0 0 84 85 0 0 101 59 59 59 59 59 59 59 59 59 59 97 0 128 0 0 0 0 0 0 129 0 
59 59 59 59 59 59 59 59 59 59 59 59 59 59 59 59 59 59 59 59 59 98 99 99 88 89 99 99 100 59 59 59 59 59 59 59 59 59 59 97 0 128 0 0 0 0 0 0 129 0 
59 59 59 59 59 59 59 59 59 59 59 59 59 59 59 59 59 59 59 59 59 59 59 59 88 89 59 59 59 59 59 59 59 59 59 59 59 59 59 97 0 130 131 136 134 135 136 136 137 0 
59 59 59 59 59 59 59 59 59 59 59 59 59 59 59 59 59 59 59 59 59 59 59 59 88 89 59 59 59 59 59 59 59 59 59 59 59 59 59 97 0 0 0 0 84 85 0 0 0 0 
59 59 59 59 59 59 59 59 59 59 59 59 59 59 59 59 59 59 59 59 59 59 59 59 88 89 59 59 59 59 59 59 59 59 59 59 59 59 59 98 99 99 99 99 88 89 99 99 99 99 
59 59 59 59 59 59 59 59 59 59 59 59 59 59 59 59 59 59 59 59 59 59 59 59 88 89 59 59 59 59 59 59 59 59 59 59 59 59 59 59 59 59 94 95 88 89 95 95 96 59 
59 59 59 59 59 59 59 59 59 59 94 95 95 96 59 59 94 95 95 96 94 95 95 95 88 89 95 95 95 95 95 95 95 95 95 95 95 95 95 96 59 59 97 0 0 0 0 0 101 59 
59 59 59 59 59 59 59 59 59 59 97 0 0 101 59 59 97 0 0 101 97 0 0 0 92 93 0 0 0 0 0 0 0 0 0 0 0 0 0 101 59 59 97 0 0 0 0 0 101 59 
59 59 59 59 59 59 59 59 59 59 97 0 0 101 59 59 97 0 0 101 97 0 0 0 0 0 0 0 0 0 0 0 0 0 0 0 0 0 0 101 59 59 97 0 0 0 0 0 101 59 
59 59 59 59 59 59 59 59 59 59 97 0 0 107 95 95 106 0 0 101 97 0 0 0 0 0 0 0 0 0 0 0 0 0 60 61 62 0 0 101 59 59 97 0 0 0 0 0 101 59 
59 59 59 59 59 59 59 59 59 59 97 0 0 0 0 0 0 0 0 101 97 0 0 0 0 0 0 0 0 0 0 0 0 0 63 68 64 0 0 101 59 59 97 0 0 0 0 0 101 59 
59 59 59 59 59 59 59 59 59 59 97 0 0 0 0 0 0 0 0 101 97 0 0 0 0 0 0 0 0 0 0 0 0 0 65 66 67 0 0 101 59 59 97 0 0 0 0 0 101 59 
59 59 59 59 59 59 59 59 59 59 97 0 0 0 0 0 0 0 0 101 97 0 0 0 0 0 0 0 0 0 84 85 0 0 0 0 0 0 0 101 59 59 97 0 0 0 0 0 101 59 
59 59 59 59 59 59 59 59 59 59 97 0 0 0 0 0 0 0 0 101 98 99 99 99 99 99 99 99 99 99 86 87 99 99 99 99 99 99 99 100 59 59 97 0 0 0 0 0 101 59 
59 59 59 59 59 59 59 59 59 59 97 0 0 0 0 0 0 0 0 101 94 95 96 94 95 95 95 95 95 95 88 89 95 95 95 95 95 95 95 96 59 59 97 0 0 0 0 0 101 59 
59 59 59 59 59 59 59 59 59 59 97 0 0 0 0 0 0 0 0 101 97 0 101 97 0 0 0 0 0 0 92 93 0 0 0 0 0 0 0 101 59 59 97 0 0 0 0 0 101 59 
59 59 59 59 59 59 59 59 59 59 97 0 0 0 0 0 0 0 0 101 97 0 101 97 0 0 0 0 0 0 0 0 0 0 0 0 0 0 0 101 59 59 97 0 0 0 0 0 101 59 
59 59 59 59 59 59 59 59 59 59 97 0 0 0 0 0 0 0 0 101 97 0 101 97 0 0 0 0 0 0 0 0 0 0 0 0 0 0 0 101 59 59 97 0 0 0 0 0 101 59 
59 59 59 59 59 59 59 59 59 59 97 0 0 0 0 0 0 0 0 101 97 0 101 97 0 0 0 0 0 0 0 0 0 0 0 0 0 0 0 101 59 59 97 0 0 0 0 0 101 59 
59 59 59 59 59 59 59 59 59 59 97 0 0 0 0 0 0 0 0 101 97 0 101 97 0 0 0 0 0 0 0 0 0 0 0 0 0 0 0 101 59 59 97 0 0 0 0 0 101 59 
59 59 59 59 59 59 59 59 59 59 97 0 0 0 0 0 0 0 0 101 98 99 100 97 0 0 0 0 0 0 0 0 0 0 0 0 0 0 0 101 59 59 97 0 0 0 0 0 101 59 
59 59 59 59 59 59 59 59 59 59 97 0 0 0 0 0 0 0 0 108 109 109 109 110 0 0 0 0 0 0 0 0 0 0 0 0 0 0 105 100 59 59 97 0 0 0 0 0 101 59 
59 59 59 59 59 59 59 59 59 59 97 0 0 0 0 0 0 0 0 111 112 112 112 113 0 0 0 0 0 0 0 0 0 0 0 0 0 0 108 109 109 109 110 0 0 0 0 0 101 59 
59 59 59 59 59 59 59 59 59 59 97 0 0 0 0 0 0 0 0 114 115 115 115 116 0 0 0 0 0 0 0 0 0 0 0 0 0 0 111 112 112 112 113 0 0 0 0 0 101 59 
59 59 59 59 59 59 59 59 59 59 97 0 0 0 0 0 0 0 0 101 59 59 59 97 0 0 0 0 51 52 52 53 0 0 0 0 0 0 114 115 115 115 116 0 0 0 0 0 101 59 
59 59 59 59 59 59 59 59 59 59 97 0 0 0 0 0 0 0 0 101 59 59 59 97 0 0 0 0 54 59 59 55 0 0 0 0 0 0 101 59 59 59 97 0 0 0 0 0 101 59 
59 59 59 59 59 59 59 59 59 59 97 0 0 0 0 0 0 0 0 101 59 59 59 97 0 0 0 0 54 59 59 55 0 0 0 0 0 0 107 96 59 59 98 99 99 99 99 99 100 59 
59 59 59 59 59 59 59 59 59 59 97 0 0 0 0 0 0 0 0 101 59 59 59 97 0 0 0 0 56 57 57 58 0 0 0 0 0 0 0 101 59 59 59 59 59 59 59 59 59 59 
59 59 59 59 59 59 59 59 59 59 97 0 0 0 0 0 0 0 0 101 59 59 59 97 0 0 0 0 0 0 0 0 0 0 0 0 0 0 0 101 59 59 59 59 59 59 59 59 59 59 
59 59 59 59 59 59 59 59 59 59 97 0 0 0 0 0 0 0 0 101 59 59 59 97 0 0 0 0 0 0 0 0 0 0 0 0 0 0 0 101 59 59 59 59 59 59 59 59 59 59 
59 59 59 59 59 59 59 59 59 59 98 99 99 99 99 99 99 99 99 100 59 59 59 97 0 0 0 0 0 0 0 0 0 0 0 0 0 0 0 101 59 59 59 59 59 59 59 59 59 59 
59 59 59 59 59 59 59 59 59 59 94 95 95 95 95 95 95 95 95 96 59 59 59 97 0 0 0 0 0 0 0 0 0 0 0 0 0 0 0 101 59 59 59 59 59 59 59 59 59 59 
59 59 59 59 59 59 59 59 59 59 97 0 0 0 0 0 0 0 0 101 59 59 59 97 0 0 0 0 0 0 0 0 0 0 0 0 0 0 0 101 59 59 59 59 59 59 59 59 59 59 
59 59 59 59 59 59 59 59 59 59 97 0 0 0 0 0 0 0 0 108 109 109 109 110 0 0 0 0 0 0 0 0 0 0 0 0 0 0 0 101 59 59 59 59 59 59 59 59 59 59 
59 59 59 59 59 59 59 59 59 59 97 0 0 0 0 0 0 0 0 112 112 112 112 113 0 0 0 0 0 0 0 0 0 0 0 0 0 0 0 101 59 59 59 59 59 59 59 59 59 59 
59 59 59 59 59 59 59 59 59 59 97 0 0 0 0 0 0 0 0 114 115 115 115 116 0 0 0 71 71 71 71 71 71 71 71 71 0 0 0 101 59 59 59 59 59 59 59 59 59 59 
59 59 59 59 59 59 59 59 59 59 97 0 84 85 0 0 0 0 0 101 59 59 59 97 0 0 0 72 73 73 73 73 73 73 73 74 0 0 0 101 59 59 59 59 59 59 59 59 59 59 
59 59 59 59 59 59 59 59 59 59 98 99 88 89 99 99 99 99 99 100 59 59 59 97 0 0 0 75 76 76 117 118 76 76 76 77 0 0 0 101 59 59 59 59 59 59 59 59 59 59 
59 59 59 59 59 59 59 59 59 59 59 59 88 89 59 59 59 59 59 59 59 59 59 97 0 0 0 75 76 76 119 120 76 76 76 77 0 0 0 101 59 59 59 59 59 59 59 59 59 59 
59 59 59 59 59 59 59 59 59 59 59 59 88 89 59 59 59 59 59 59 59 59 59 97 0 0 0 75 76 76 76 76 76 76 76 77 0 0 0 101 59 59 59 59 59 59 59 59 59 59 
59 59 59 59 59 59 59 59 59 59 59 59 88 89 59 59 59 59 59 59 59 59 59 98 99 99 99 121 122 122 122 122 122 122 122 123 99 99 99 100 59 59 59 59 59 59 59 59 59 59 
59 59 59 59 59 59 59 59 94 95 95 95 88 89 95 96 59 59 59 59 59 59 59 59 59 59 59 59 59 59 59 59 59 59 59 59 59 59 59 59 59 59 59 59 59 59 59 59 59 59 
59 59 59 59 59 59 59 59 97 0 0 0 92 93 0 101 59 59 59 59 59 59 59 59 59 59 59 59 59 59 59 59 59 59 59 59 59 59 59 59 59 59 59 59 59 59 59 59 59 59 
59 59 59 59 59 59 59 59 97 0 0 0 0 0 0 101 59 59 59 59 59 59 59 59 59 59 59 59 59 59 59 59 59 59 59 59 59 59 59 59 59 59 59 59 59 59 59 59 59 59 
59 59 59 59 59 59 59 59 97 0 0 0 0 0 0 101 59 59 59 59 59 59 59 59 59 59 59 59 59 59 59 59 59 59 59 59 59 59 59 59 59 59 59 59 59 59 59 59 59 59 
59 59 59 59 59 59 59 59 97 0 0 0 0 0 0 101 59 59 59 59 59 59 59 59 59 59 59 59 59 59 59 59 59 59 59 59 59 59 59 59 59 59 59 59 59 59 59 59 59 59 
59 59 59 59 59 59 59 59 98 99 99 99 99 99 99 100 59 59 59 59 59 59 59 59 59 59 59 59 59 59 59 59 59 59 59 59 59 59 59 59 59 59 59 59 59 59 59 59 59 59 
